{
  "width": 100,
  "height": 18,
  "tileSize": 16,
  "rows": [
    "0000000000000000000000000000000000000000000000000000000000000000000000000000000000000000000000000000",
    "0000000000000000000000000000000000000000000000000000000000000000000000000000000000000000000000000000",
    "0000000000000000000000000000000000000000000000000000000000000000000000000000000000000000000000000000",
    "0000000000000000000000000000000000000000000000000000000000000000000000000000000000000000000000000000",
    "0000000000000000000000000000000000000000000000000000000000000000000000000000000000000000000000000000",
    "0000000011111111000000000000000000000000000000000000000000000000000000000000000000000000000000000000",
    "0000000000000000000000000000000000000000000000000000000000000000000000000000000000000000000000000000",
    "0000000000000000000000111111110000000000000000000000000000000000000000000000000000000000000000000000",
    "0000000000000000000000000000000000000000000000000000000000000000000000000000000000000000000000000000",
    "0000000000000000000000000000000011111100000000000000000000000000000000000000000000000000000000000000",
    "0000000000000000000000000000000000000000000000000000000000000000000000000000000000000000000000000000",
    "0000000000000000000000000000000000000000000000000000000000000000000000000000000000000000000000000000",
    "0000011111111000000000000000000000000000000000000000000000000000000000000000000000000000000000000000",
    "0000000000000000000000000000000000000000000000000000000000000000000000000000000000000000000000000000",
    "0000000000000000000000000000000000000000111111000000000000000000000000000000000000000000000000000000",
    "0000000000000000000000000000000000000000000000000000000000000000000000000000000000000000000000000000",
    "0011100000000000000000000000000000000000000000000000000000000000000000000000000000000000000000000000",
    "1111111111111111111111111111111111111111111111111111111111111111111111111111111111111111111111111111"
  ]
}
