{
  "width": 50,
  "height": 18,
  "tileSize": 16,
  "rows": [
    "00000000000000000000000000000000000000000000000000",
    "00000000000000000000000000000000000000000000000000",
    "00000000000000000000000000000000000000000000000000",
    "00000000000000000000000000000000000000000000000000",
    "00000000000000000000000000000000000000000000000000",
    "00000000111111110000000000000000000000000000000000",
    "00000000000000000000000000000000000000000000000000",
    "00000000000000000000001111111100000000000000000000",
    "00000000000000000000000000000000000000000000000000",
    "00000000000000000000000000000000111111000000000000",
    "00000000000000000000000000000000000000000000000000",
    "00000000000000000000000000000000000000000000000000",
    "00000111111110000000000000000000000000000000000000",
    "00000000000000000000000000000000000000000000000000",
    "00000000000000000000000000000000000000001111110000",
    "00000000000000000000000000000000000000000000000000",
    "00111000000000000000000000000000000000000000000000",
    "11111111111111111111111111111111111111111111111111"
  ]
}