{
  "width": 100,
  "height": 18,
  "tileSize": 16,
  "background": "assets/environment/background/sky.png",
  "background_scale": 1.0,
  "clouds": true,
  "background_layers": [
    {
      "path": "assets/environment/background/mountains.png",
      "scale": 1.0,
      "parallax": 0.2,
      "repeat": true,
      "repeat_x": true
    }
  ],
  "entities": [
    {
      "type": "player",
      "x": 2,
      "y": 15
    }
  ],
  "rows": [
    "0000000000000000000000000000000000000000000000000000000000000000000000000000000000000000000000000000",
    "0000000000000000000000000000000000000000000000000000000000000000000000000000000000000000000000000000",
    "0000000000000000000000000000000000000000000000000000000000000000000000000000000000000000000000000000",
    "0000000000000000000000000000000000000000000000000000000000000000000000000000000000000000000000000000",
    "00000000000000000000000000000000000000000000000000000000000000000000000000G0000000000000000000000000",
    "0000000000000000000000000000000000000000000000000000000000000000000001111111110000000000000000000000",
    "00000000000000000000000K0000000000000000000000000000000000000000000000000000000000000000000000000000",
    "0000000000000000000000111111111111111100000000000000000000000000000000000000000000000000000000000000",
    "0000000000000000000000000000000000000000000000000000000000000000000000000000000000000000000000000000",
    "0000000000000000000000000000000000000000000000000000000000G00000000000000000000000000000000000000000",
    "0000000000000000000000000000000000000000000000000011110011110000000000000000000000000000000000000000",
    "00000G0000000000000000000000000000000000000000000000000000000000000000000000000000000000000000000000",
    "0000011111111000000000000000000000000000000000000000000000000000000000000000000000000000000000000000",
    "0000000000000000000000000000000000000000000000000000000000000000000000000000000000000000000K00000000",
    "0000000000000000000000000000000000000000011111110000000000000000000000000000000000000000111111000000",
    "0000000000000000000000000000000000000000000000000000000000000000000000000000000000000000000000000000",
    "0011100000000000000000000000000000000000000000000000000000000000000000000000000000000000000000000000",
    "0000000000000111111111111100000000000000000000000000000000000011111111111111111111111111100001111111"
  ]
}
